SO ./texture/duck_s.xpm
NO ./texture/duck_n.xpm
WE ./texture/duck_w.xpm
EA ./texture/duck_e.xpm

F 31, 31, 31
C 38,141,114

        111111111 11111111111111
        100000001 1000000000001
        101100001110000011100001
        1001000000000000001000001
111111111011000001110000011100001
100000000011000001110111111111111
11110111111111011100000010001
11110111111111011101010010001
11000000110101011100000010001
10000000000000001100000010001
1000E000000000001101010010001
11000001110101011111011110001
11110111 1110101 101111010001
11111111 1111111 111111111111