F 31     ,31,31
C 38 ,0 ,114

SO ./texture/duck_s.xpm

NO ./texture/duck_n.xpm
WE ./texture/duck_w.xpm
EA ./texture/duck_e.xpm

        1111111111111111111111111
        1000101000110000000000001
        1011100001110000011100001
        1001000000000000001000001
111111111011000001110000011100001
100000000011000001110111111111111
111111111111111111111111111111111
111111111111111111111111111111111
11101111111110111000000100001
11110111111111011101010010001
11000000110101011100000010001
10000000000000110000001000001
10000E00000000000110101001001
11000001110101011111011110001
11110111 1110101 101111010001
11111111 1111111 111111111111











